1111111
1000001
1PC0E01
10C0001
1111111