111111111111111111111111111111
1000000001110000000C0000000001
101111110101011111111011111101
10000001000100000C001000000001
1C1110101111101111011110101111
100001000000000100001000010001
101101111111110101111011110101
1001000C00P0000100001000001001
101101111111110101111011110101
1000010000000001000010000C1001
1C1110101111101111011110101111
10000001000100000C0010000000C1
101111110101011111111011111101
1000000001110000000C00000000E1
111111111111111111111111111111
