1111111111111111111
1P000000C0000000001
1110111110111111101
1C00100000100000001
1011010111110101111
100001000C000100001
1C111010111110101C1
1000010100000100001
1011110101111101111
1000000100000000001
1C01111101111111001
1000100000100000C01
100000C0000000000E1
1111111111111111111

